***************
*----- 2 -----*
*-*-*-*D*-*-*-*
**---*---*---**
*-*-*-*-*-*-*-*
*R --- U --- L*
*3*-*-*1*-*-*4*
*R --- D --- L*
*-*-*-*-*-*-*-*
**---*---*---**
*-*-*-*U*-*-*-*
*----- 5 -----*
***************