***************
*2 --D*-*D-- 4*
*D*-*-*-*-*-*D*
*-------------*
*-*-*-* *-*-*-*
*D---L* *R---D*
*-*****1*****-*
*U---L* *R---U*
*-*-*-* *-*-*-*
*-------------*
*U*-*-*-*-*-*U*
*3 --U*-*U-- 5*
***************