***************
*2 ---*-*--- 4*
* *-*-*-***-* *
*-----*-*-----*
*-***** *****-*
*------ ------*
*-*-*-*1*-*-*-*
*------ ------*
*-***** *****-*
*-----*-*-----*
* *-*-*-*-*-* *
*3 ---*-*--- 5*
***************