***************
*------ ------*
*-*-*-*-*-*-*-*
*-*--- 1 ---*-*
*-*-*-* *-*-*-*
*-------------*
***************
*-------------*
*-*-*-* *-*-*-*
*-*--- 2 ---*-*
*-*-*-*-*-*-*-*
*------ ------*
***************
