***************
*1R    -    L3*
* *-*-*-*-*-* *
*R           L*
* *-*-*-*-*-* *
*R           L*
* *-*-*5*-*-* *
*R           L*
* *-*-*-*-*-* *
*R           L*
* *-*-*-*-*-* *
*4R    -    L2*
***************
