***************
*1 D-------D 3*
* *-*-*-*-*-* *
*D*-*-*-*-*-*D*
*-*-*-*-*-*-*-*
*-*-*-   ---*-*
*-*-*-*5*-*-*-*
*-*-*-   ---*-*
*-*-*-*-*-*-*-*
*U*-*-*-*-*-*U*
* *-*-*-*-*-* *
*4 U-------U 2*
***************
