***************
*1 R-------L 3*
* *****-***** *
*R-----------L*
*-*****-*****-*
*R-D--L R--D-L*
*-*-*-*5*-*-*-*
*R-U--L R--U-L*
*-*****-*****-*
*R-----------L*
* *****-***** *
*4 R-------L 2*
***************
