***************
*1 D---L---L 3*
* *-*-*-*-*-* *
*--D---U---U--*
*-*-*-*-*-*-*-*
*--D-- U --U--*
*-*-*-*5*-*-*-*
*--D-- D --U--*
*-*-*-*-*-*-*-*
*--D---D---U--*
* *-*-*-*-*-* *
*4 R---R---U 2*
***************
