***************
*1 DR-----LD 3*
*D*-*-*-*-*-*D*
*-*----U----*-*
*-*-*******-*-*
*-*--- L ---*-*
*-*-*-*5*-*-*-*
*-*--- R ---*-*
*-*-*******-*-*
*-*----D----*-*
*U*-*-*-*-*-*U*
*4 UR-----LU 2*
***************
