***************
* 1--*---*--2 *
*D*D**-*-**D*D*
*---**---**---*
*-*-**-*-**-*-*
*---**---**---*
*-*-**-*-**-*-*
*---**---**---*
*-*-**-*-**-*-*
*---**---**---*
*-*-*-U*U-*-*-*
*---** 3 **---*
***************
