***************
*1    ---    3*
*-* * *-* * *-*
*--R       L--*
*-* * * * * *-*
*--  U   U  --*
*-* * *5* * *-*
*--  D   D  --*
*-* * * * * *-*
*--R       L--*
*-* * *-* * *-*
*4    ---    2*
***************
