***************
*1     D     3*
* *-*-* *-*-* *
*R           L*
* *-*-* *-*-* *
*   -   -   - *
* * * *5* * * *
* -   -   -   *
* *-*-* *-*-* *
*R           L*
* *-*-* *-*-* *
*4     U     2*
***************
