***************
*2R---------L4*
* *-*-*-*-*-* *
*R-----------L*
*-***********-*
*R----L R----L*
*-*-*-*1*-*-*-*
*R----L R----L*
*-***********-*
*R-----------L*
* *-*-*-*-*-* *
*3R---------L5*
***************