***************
*D---- 2 ----D*
*-*-*** ***-*-*
*-*---*-*---*-*
* *-*-* *-*-* *
* *---*U*---* *
*3*-*-*1*-*-*4*
* *---*D*---* *
* *-*-* *-*-* *
*-*---*-*---*-*
*-***-* *-***-*
*U---- 5 ----U*
***************