***************
*----- 2 -----*
*-*-*-* *-*-*-*
**---*---*---**
*-*-*-*-*-*-*-*
*  ---   ---  *
*3*-*-*1*-*-*4*
*  ---   ---  *
*-*-*-*-*-*-*-*
**---*---*---**
*-*-*-* *-*-*-*
*----- 5 -----*
***************