***************
*1 D   L   L 3*
* * *-*-*-* * *
*-- ------- --*
*-*D*-*-*-*U*-*
*-- --   -- --*
*-* *-*5*-* *-*
*-- --   -- --*
*-*D*-*-*-*U*-*
*-- ------- --*
* * *-*-*-* * *
*4 R   R   U 2*
***************
