***************
*1RD  -L-  LL3*
*D* * * * * *D*
*    D - L    *
* *D* * * *U* *
*    - U -    *
*-* *D*5*U* *-*
*    - D -    *
* *D* * * *U* *
*    R - U    *
*U* * * * * *U*
*4RR  -R-  UL2*
***************
