***************
*1R---------L3*
*D*-*-***-*-*D*
*-----***-----*
*-***********-*
*-***********-*
*-***********-*
*-***********-*
*-***********-*
*-----***-----*
*U*-*-***-*-*U*
*4L---------R2*
***************
