***************
*1 ----*---- 3*
*U***********U*
*-----L-R-----*
*-***********-*
*U----L R----U*
*******5*******
*D----L R----D*
*-***********-*
*-----L-R-----*
*D***********D*
*4 ----*---- 2*
***************
