***************
*1R---------L3*
*D*-*-*-*-*-*D*
*-----*-*-----*
*-*****-*****-*
*-****-U-****-*
*-----L5R-----*
*-****-D-****-*
*-*****-*****-*
*-----*-*-----*
*U*-*-*-*-*-*U*
*4L---------R2*
***************
