***************
*1 -*D---D*- 3*
* *-*-***-*-* *
*---*-----*---*
***-*-***-*-***
*-----L R-----*
*-***-*5*-***-*
*-----L R-----*
***-*-***-*-***
*---*-----*---*
* *-*-***-*-* *
*4 -*U---U*- 2*
***************
