***************
***-*******-***
*** *-----* ***
*- 1--*-*--2 -*
***D*-*U*-*D***
***-*-* *-*-***
***-*-*5*-*-***
***-*-* *-*-***
***U*-*D*-*U***
*- 4--*-*--3 -*
*** *-----* ***
***-*******-***
***************
