***************
*1 --------- 3*
*D*-*-*-*-*-*D*
*-R---------L-*
*-*****U*****-*
*-***** *****-*
*-*****5*****-*
*-***** *****-*
*-*****D*****-*
*-R---------L-*
*U*-*-*-*-*-*U*
*4 --------- 2*
***************
