***************
*1 --------- 3*
*D***-*-*-***D*
*-*D--* *--D*-*
*-*-*-* *-*-*-*
*-----*U*-----*
*-*-***5***-*-*
*-----*D*-----*
*-*-*** ***-*-*
*-*U--* *--U*-*
*U***-*-*-***U*
*4 --------- 2*
***************
