***************
*-*D-- 2 --D*-*
*-*-*** ***-*-*
*R-----------L*
* *-*-*-*-*-* *
* *-*-   -*-* *
*3*-*-*1*-*-*4*
* *-*-   -*-* *
* *-*-*-*-*-* *
*R-----------L*
*-*-*** ***-*-*
*-*U-- 5 --U*-*
***************