***************
*2 ---*-*--- 4*
* *-*-*-***-* *
*-----*-*-----*
*-***** *****-*
*R----L R----L*
*-*-*-*1*-*-*-*
*R----L R----L*
*-***** *****-*
*-----*-*-----*
* *-*-*-*-*-* *
*3 ---*-*--- 5*
***************