***************
*5 --*---*----*
* *-*-* *-*-*-*
**-R---------L*
* ***** ****-**
*4 ---*U*-----*
*-*-*-*3*-*-*-*
*-----*D*--- 2*
**-**** ***** *
*R---------L-**
*-*-*-*-*-*-* *
*----*---*-- 1*
***************