***************
*----- 2 -----*
*-***** *****-*
*R-----------L*
* *-*-*-*-*-* *
* *---  *---* *
*3*-*-*1*-*-*4*
* *---*  ---* *
* *-*-*-*-*-* *
*R-----------L*
*-***** *****-*
*----- 5 -----*
***************