***************
*L----*2*----R*
*-*-*** ***-*-*
*-*--- D ---*-*
* *-*-*-*-*-* *
*U*--- U ---*U*
*3*-*-*1*-*-*4*
*D*--- D ---*D*
* *-*-*-*-*-* *
*-*--- U ---*-*
*-*-*** ***-*-*
*L----*5*----R*
***************