***************
*R----   ----L*
*-***** *****-*
*R-----------L*
* *-*-* *-*-* *
* *---* *---* *
*1*-*-*2*-*-*3*
* *---* *---* *
* *-*-* *-*-* *
*R-----------L*
*-***** *****-*
*R----   ----L*
***************