***************
*---*- 2 -*---*
*-*-*-*D*-*-*-*
*R-----------L*
*-*****-*****-*
*  -*- U -*-  *
*3*-*-*1*-*-*4*
*  -*- D -*-  *
*-*****-*****-*
*R-----------L*
*-*-*-*U*-*-*-*
*---*- 5 -*---*
***************