***************
*R---  2  ---L*
*-*-*-***-*-*-*
*-------------*
*-*-*-*-*-*-*-*
*U -*-   -*- U*
*3*-*-*1*-*-*4*
*D -*-   -*- D*
*-*-*-*-*-*-*-*
*-------------*
*-*-*-***-*-*-*
*R---  5  ---L*
***************