***************
*2 ----D---- 4*
*D*-*-*-*-*-*D*
*-*-----------*
*-*****-*****-*
*-*--- U ---*-*
*-*-*-*1*-*-*-*
*-*--- D ---*-*
*-*****-*****-*
*-*---------*-*
*U*-*-*-*-*-*U*
*3 ----U---- 5*
***************