***************
*1 D---L---L 3*
* *-*-*-*-*-* *
*-------------*
*-*-*-*-*-*-*-*
*-----   -----*
*-*D*-*5*-*U*-*
*-----   -----*
*-*-*-*-*-*-*-*
*-------------*
* *-*-*-*-*-* *
*4 R---R---U 2*
***************
