***************
*1R    -    L3*
*D*-*-*-*-*-*D*
* ----------- *
* *-*-*-*-*-* *
* ----   ---- *
*-*-*-*5*-*-*-*
* ----   ---- *
* *-*-*-*-*-* *
* ----------- *
*U*-*-*-*-*-*U*
*4R    -    L2*
***************
