***************
*1 D   L   L 3*
* * * * * * * *
*    D   L    *
* *D* * * *U* *
*      U      *
* * *D*5*U* * *
*      D      *
* *D* * * *U* *
*    R   U    *
* * * * * * * *
*4 R   R   U 2*
***************
