***************
*1 D D D D D 3*
*D* * * * * *D*
* - - - - - - *
* * * * * * * *
* - -     - - *
*-* * *5* * *-*
* - -     - - *
* * * * * * * *
* - - - - - - *
*U* * * * * *U*
*4 U U U U U 2*
***************
