***************
*1 D D D D D 3*
*D* * * * * *D*
* - - - - - - *
* * * * * * * *
*U- - * * - -U*
*-* * *5* * *-*
*D- - * * - -D*
* * * * * * * *
* - - - - - - *
*U* * * * * *U*
*4 U U U U U 2*
***************
