***************
*1R  D - D  L3*
* *-*-*-*-*-* *
*R   D   D   L*
* *-*-*-*-*-* *
*R   D   D   L*
* *-*-*5*-*-* *
*R   U   U   L*
* *-*-*-*-*-* *
*R   U   U   L*
* *-*-*-*-*-* *
*4R  U - U  L2*
***************
