***************
*1R  L - R  L3*
* *-*-*-*-*-* *
*D   U   U   L*
* *-*-*-*-*-* *
*U   D   D   U*
* *-*-*5*-*-* *
*D   U   U   D*
* *-*-*-*-*-* *
*U   D   D   L*
* *-*-*-*-*-* *
*4R  L - R  L2*
***************
