***************
*1 D*--D--*D 3*
* *-*-*-*-*-* *
*-*---*-*---*-*
*-*-*-*-*-*-*-*
*-****- -****-*
*-----L5R-----*
*-****- -****-*
*-*-*-*-*-*-*-*
*-*---*-*---*-*
* *-*-*-*-*-* *
*4 U*--U--*U 2*
***************
