***************
*1 -*-----*- 3*
*D***-***-***D*
*-*--U*-*U--*-*
*-*-*-*-*-*-*-*
*-***-  *-*-*-*
*---*-*5*-*---*
*-*-*-*  -***-*
*-*-*-*-*-*-*-*
*-*--D*-*D--*-*
*U***-***-***U*
*4 -*-----*- 2*
***************
