***************
*1   D*-*D   3*
*****-*-*-*****
*-*---------*-*
*-*-*-*-*-*-*-*
*----- U -----*
*-*****5*****-*
*----- D -----*
*-*-*-*-*-*-*-*
*-*---------*-*
*****-*-*-*****
*4   U*-*U   2*
***************
