***************
*R-D-------D-L*
*-*-*-*-*-*-*-*
*---- - - ----*
*-*-*U* *U*-*-*
*U-L 1* *3 R-U*
*-*-* *5* *-*-*
*D-L 4* *2 R-D*
*-*-*D* *D*-*-*
*---- - - ----*
*-*-*-*-*-*-*-*
*R-U*-----*U-L*
***************
