***************
*1 -----*--- 3*
*D***-***-***D*
*-*------L*-*-*
*-*-*******-*-*
*-----*  -----*
*-*-*-*5*-*-*-*
*-----  *-----*
*-*-*******-*-*
*-*-*R------*-*
*U***-***-***U*
*4 ---*----- 2*
***************
