***************
*D----L2R----D*
*-*D*** ***D*-*
*-*---*-*---*-*
* *-*-* *-*-* *
* *-*-*U*-*-* *
*3*-*-*1*-*-*4*
* *-*-*D*-*-* *
* *-*-* *-*-* *
*-*---*-*---*-*
*-***U* *U***-*
*U----L5R----U*
***************