***************
*-*---L2R---*-*
*-*-*-* *-*-*-*
*------*------*
*-***-*-*-***-*
*U ---L R--- U*
*3*****1*****4*
*D ---L R--- D*
*-***-*-*-***-*
*------*------*
*-*-*-* *-*-*-*
*-*---L5R---*-*
***************