***************
*D---- 2 ----D*
*-*-*-* *-*-*-*
*-*-*-----*-*-*
* *-*-*-*-*-* *
*U*-*- U -*-*U*
*3***-*1*-***4*
*D*-*- D -*-*D*
* *-*-*-*-*-* *
*-*-*-----*-*-*
*-*-*-* *-*-*-*
*U---- 5 ----U*
***************