***************
*-*D-- 2 --D*-*
*-*-*-*D*-*-*-*
*-------------*
***-*-* *-*-***
*R ---*U*--- L*
*3*-*-*1*-*-*4*
*R ---*D*--- L*
***-*-* *-*-***
*-------------*
*-*-*-*U*-*-*-*
*-*U-- 5 --U*-*
***************