***************
*-----L2R-----*
*-*-*-* *-*-*-*
*-------------*
*-*-*-*-*-*-*-*
*U --- U --- U*
*3*-*-*1*-*-*4*
*D --- D --- D*
*-*-*-*-*-*-*-*
*-------------*
*-*-*-* *-*-*-*
*-----L5R-----*
***************