***************
*5R----L------*
* *-*-* *-*-*-*
**------------*
* *-*-* *-*-*-*
*4R--U*U*-----*
*******3*******
*-----*D*D--L2*
*-*-*-* *-*-* *
*------------**
*-*-*-*-*-*-* *
*------R----L1*
***************