***************
**4R ---------*
*1* *-* *-*-*-*
*D *----------*
* *-*-*-*-*-*-*
*----*--------*
*-*-*-* *-*-*-*
*--------*----*
*-*-*-*-*-*-* *
*----------* U*
*-*-*-*-*-* *2*
*--------- L3**
***************