***************
*-----L2R-----*
*-*-*-*D*-*-*-*
*--*-------*--*
*-*-*-*-*-*-*-*
*U --* U *-- U*
*3*-*-*1*-*-*4*
*D --* D *-- D*
*-*-*-*-*-*-*-*
*--*-------*--*
*-*-*-*U*-*-*-*
*-----L5R-----*
***************