***************
**---- 2 -----*
*-*-*-*D*-*-*-*
*--*----------*
*-*-*-*-*-*-*-*
*  --* U --- U*
*3*-*-*1*-*-*4*
*D --- D *--  *
*-*-*-*-*-*-*-*
*----------*--*
*-*-*-*U*-*-*-*
*----- 5 ----**
***************