***************
*1R  L - R  L3*
* *-*-*-*-*-* *
*R   U   U   L*
* *-*-*-*-*-* *
*R   U   U   L*
* *-*-*5*-*-* *
*R   D   D   L*
* *-*-*-*-*-* *
*R   D   D   L*
* *-*-*-*-*-* *
*4R  L - R  L2*
***************
