***************
*1 R-------L 3*
* *********** *
*R-----------L*
*-***********-*
*R----   ----L*
*-*****5*****-*
*R----   ----L*
*-***********-*
*R-----------L*
* *********** *
*4 R-------L 2*
***************
