***************
*1 ----*---- 3*
*D***********D*
*-R---------L-*
*-***********-*
*R----   ----L*
*******5*******
*R----   ----L*
*-***********-*
*-R---------L-*
*U***********U*
*4 ----*---- 2*
***************
