***************
*1R---------L3*
* *********** *
*R-----------L*
*******-*******
*----- U -----*
*-*****5*****-*
*----- D -----*
*******-*******
*R-----------L*
* *********** *
*4R---------L2*
***************
