***************
*1 -*D-L--*- 3*
*D***-*-*-***D*
*-*---*-*---*-*
*-*-*-*-*-*-*-*
*-*-*- U*-*-*-*
*---*-*5*-*---*
*-*-*-*D -*-*-*
*-*-*-*-*-*-*-*
*-*---*-*---*-*
*U***-*-*-***U*
*4 -*--R-U*- 2*
***************
