***************
*1 ------L*- 3*
* ***-***-*** *
*-*---*-*---*-*
*-*-*-*-*-*-*-*
*****-  *-***-*
*R----*5*----L*
*-***-*  -*****
*-*-*-*-*-*-*-*
*-*---*-*---*-*
* ***-***-*** *
*4 -*R------ 2*
***************
