***************
*1 --D*-*D-- 3*
* ***-*-*-*** *
*---*-----*---*
*-*-*******-*-*
*---*R- ------*
*-*-*- 5 -*-*-*
*------ -L*---*
*-*-*******-*-*
*---*-----*---*
* ***-*-*-*** *
*4 --U*-*U-- 2*
***************
