***************
***-*******-***
*** ******* ***
*- 1-------2 -*
***-*-*-*-*-***
***--R   D--***
***-*-*5*-*-***
***--U   L--***
***-*-*-*-*-***
*- 4-------3 -*
*** ******* ***
***-*******-***
***************
